111111111111111111111111
1001000000000C00000000C1
10000111110000P000E00c01
111111111111111111111111
