111111111111111
1000000000C0001
100000P00000001
100000000000001
111111111111111