111111111111111111111111
100100000000000000010111
11100111110000E001000001
10P000000000C0001C100001
111111111111111111111111
