1111111111111
1N0100C0E0N01
1000011011001
1P0011C000001
1111111111111
